#leveldata
#background
109 110 111
#foreground
00 00 00 00 00 00 00 00 00 00 00 00 00 00
00 00 00 00 00 00 00 00 00 00 00 00 00 00
00 00 00 00 00 00 00 00 00 00 00 00 00 00
00 00 00 00 00 00 00 00 00 00 00 00 00 00
00 00 00 00 00 00 00 00 00 00 00 00 00 00
00 00 00 00 00 00 00 00 00 00 00 00 00 00
00 00 00 00 00 00 00 00 00 00 00 00 00 00
00 00 00 00 00 00 00 00 00 00 00 00 00 00
00 00 00 00 00 00 00 00 00 00 00 00 00 00
00 00 00 00 00 00 00 00 00 00 00 00 00 00
75 00 70 00 74 00 73 00 00 71 00 75 00 72
33 34 34 34 34 34 34 34 34 34 34 34 34 35
30 30 30 30 32 30 30 30 30 75 73 30 30 31
30 30 31 30 30 30 30 32 33 34 35 30 30 30
32 30 30 30 30 31 30 30 30 30 30 30 32 30
#bottomBackground
30
#waterLine
true 82