#leveldata
#background
103 104 105
#foreground
00 00 00 00 00 00 00 00 00 00 00 00 00 00
00 00 00 00 00 00 00 00 00 00 00 00 00 00
00 00 00 00 00 00 00 00 00 00 00 00 00 00
00 00 00 00 00 00 00 00 00 00 00 00 00 00
00 00 00 00 00 00 00 00 00 00 00 00 00 00
00 00 00 00 00 00 00 00 00 00 00 00 00 00
00 00 00 00 00 00 00 00 00 00 00 00 00 00
00 00 00 00 00 00 00 00 00 00 00 00 00 00
00 00 00 00 00 00 00 00 00 00 00 00 00 00
00 00 00 00 00 00 00 00 00 00 00 00 00 00
55 00 50 00 54 00 53 00 00 51 00 55 00 52
13 14 14 14 14 14 14 14 14 14 14 14 14 15
10 10 10 10 12 10 10 10 10 55 53 10 10 11
10 10 11 10 10 10 10 12 13 14 15 10 10 10
12 10 10 10 10 11 10 10 10 10 10 10 12 10
#bottomBackground
10
#waterLine
true 80