#leveldata
#background
100 101 102
#foreground
00 00 00 00 00 00 00 00 00 00 00 00 00 00
00 00 00 00 00 00 00 00 00 00 00 00 00 00
00 00 00 00 00 00 00 00 00 00 00 00 00 00
00 00 00 00 00 00 00 00 00 00 00 00 00 00
00 00 00 00 00 00 00 00 00 00 00 00 00 00
00 00 00 00 00 00 00 00 00 00 00 00 00 00
00 00 00 00 00 00 00 00 00 00 00 00 00 00
00 00 00 00 00 00 00 00 00 00 00 00 00 00
00 00 00 00 00 00 00 00 00 00 00 00 00 00
00 00 00 00 00 00 00 00 00 00 00 00 00 00
45 00 40 00 44 00 43 00 00 41 00 45 00 42
04 05 05 05 05 05 05 05 05 05 05 05 05 06
01 01 01 01 03 01 01 01 01 45 43 01 01 02
01 01 02 01 01 01 01 03 04 05 06 01 01 01
03 01 01 01 01 02 01 01 01 01 01 01 03 01
#bottomBackground
01
#waterLine
true 83