#leveldata
#background
106 107 108
#foreground
00 00 00 00 00 00 00 00 00 00 00 00 00 00
00 00 00 00 00 00 00 00 00 00 00 00 00 00
00 00 00 00 00 00 00 00 00 00 00 00 00 00
00 00 00 00 00 00 00 00 00 00 00 00 00 00
00 00 00 00 00 00 00 00 00 00 00 00 00 00
00 00 00 00 00 00 00 00 00 00 00 00 00 00
00 00 00 00 00 00 00 00 00 00 00 00 00 00
00 00 00 00 00 00 00 00 00 00 00 00 00 00
00 00 00 00 00 00 00 00 00 00 00 00 00 00
00 00 00 00 00 00 00 00 00 00 00 00 00 00
65 00 60 00 64 00 63 00 00 61 00 65 00 62
23 24 24 24 24 24 24 24 24 24 24 24 24 25
20 20 20 20 22 20 20 20 20 65 63 20 20 21
20 20 21 20 20 20 20 22 23 24 25 20 20 20
22 20 20 20 20 21 20 20 20 20 20 20 22 20
#bottomBackground
20
#waterLine
true 80